Expert
+---+---+---+---+
|   | T | F | C |
+---+---+---+---+
|   | C |   | P |
+---+---+---+---+
|   |   |   | F |
+---+---+---+---+
| P | T |   |   |
+---+---+---+---+