Avancé
+---+---+---+---+
|   |   | F |   |
+---+---+---+---+
| C |   |   | P |
+---+---+---+---+
|   | C |   |   |
+---+---+---+---+
|   | P | F |   |
+---+---+---+---+