Expert
+---+---+---+---+
|   |   | P | F |
+---+---+---+---+
|   | T | T |   |
+---+---+---+---+
| P | F |   |   |
+---+---+---+---+
| C | C |   |   |
+---+---+---+---+