Expert
+---+---+---+---+
|   | P |   |   |
+---+---+---+---+
|   | T | T |   |
+---+---+---+---+
|   |   | C | C |
+---+---+---+---+
| F |   | P | F |
+---+---+---+---+